1111111111111111111
100000000000000P001
1000000000000000001
1000000000000000001
100000000000000C001
10000000000000000E1
1111111111111111111