1111111111111111111111111
1000000000000000000000001
1000000000000000000000001
1000000P00000000000000001
1000000000000000000000001
10000F00000000000E0000001
1000000C00000000000000001
1000000000000000000000001
1000000000000000000000001
1111111111111111111111111
