1111111111111111111111111
1P10000000000100000000001
1010100000000100000000001
1010000000000100000000001
10000000C0000000F00000F01
1010100000000000000000001
1010100000000F01000000001
10000000000000F00000000E1
1111111111111111111111111